50,10
WWWWWWWWWWWWWWWWWWWWWWWWWWWWWWWWWWWWWWWWWWWWWWWWWW
W                                                W
W                                                W
W               S                                W
W                                                W
W                                           H    W
W                                                W
W              B                                 W
W                                                W
WWWWWWWWWWWWWWWWWWWWWWWWWWWWWWWWWWWWWWWWWWWWWWWWWW